R   2560   1440
NO    ./texture/purplestone.xpm
SO     ./texture/mossy.xpm
WE ./texture/eagle.xpm
EA ./texture/greystone.xpm
S ./texture/barrel.xpm

F 1,1,1
C 1,1,1

        1111111111111111111111111
        1000000000110000000000001
        101100W011100000020000011
        1001000000000000002000001
111111111011000001110000000000001          1111
100000000011000001110111111101111         100001
11110111111111011100000010001             100001
11110111111111011101010010001              1111 
11000111110101011100000000001
10000000020000001100000010001
10000000000000011010100010001
110000011101010111110111100011
11110111111101011101111010001
111111111 1111111111111111111
